Auburn	Alabama
Birmingham	Alabama
Decatur	Alabama
Dothan	Alabama
Florence	Alabama
Hoover	Alabama
Huntsville	Alabama
Madison	Alabama
Mobile	Alabama
Montgomery	Alabama
Phenix City	Alabama
Tuscaloosa	Alabama
Anchorage	Alaska
Apache Junction	Arizona
Avondale	Arizona
Buckeye	Arizona
Bullhead City	Arizona
Casa Grande	Arizona
Chandler	Arizona
Flagstaff	Arizona
Gilbert	Arizona
Glendale	Arizona
Goodyear	Arizona
Lake Havasu City	Arizona
Marana	Arizona
Maricopa	Arizona
Mesa	Arizona
Oro Valley	Arizona
Peoria	Arizona
Phoenix	Arizona
Prescott	Arizona
Prescott Valley	Arizona
Scottsdale	Arizona
Sierra Vista	Arizona
Surprise	Arizona
Tempe	Arizona
Tucson	Arizona
Yuma	Arizona
Bentonville	Arkansas
Conway	Arkansas
Fayetteville	Arkansas
Fort Smith	Arkansas
Jonesboro	Arkansas
Little Rock	Arkansas
North Little Rock	Arkansas
Pine Bluff	Arkansas
Rogers	Arkansas
Springdale	Arkansas
Alameda	California
Alhambra	California
Aliso Viejo	California
Anaheim	California
Antioch	California
Apple Valley	California
Arcadia	California
Azusa	California
Bakersfield	California
Baldwin Park	California
Beaumont	California
Bell Gardens	California
Bellflower	California
Berkeley	California
Brea	California
Brentwood	California
Buena Park	California
Burbank	California
Calexico	California
Camarillo	California
Campbell	California
Carlsbad	California
Carson	California
Cathedral City	California
Ceres	California
Cerritos	California
Chico	California
Chino	California
Chino Hills	California
Chula Vista	California
Citrus Heights	California
Clovis	California
Coachella	California
Colton	California
Compton	California
Concord	California
Corona	California
Costa Mesa	California
Covina	California
Culver City	California
Cupertino	California
Cypress	California
Daly City	California
Danville	California
Davis	California
Delano	California
Diamond Bar	California
Downey	California
Dublin	California
Eastvale	California
El Cajon	California
El Centro	California
El Monte	California
Elk Grove	California
Encinitas	California
Escondido	California
Fairfield	California
Folsom	California
Fontana	California
Fountain Valley	California
Fremont	California
Fresno	California
Fullerton	California
Garden Grove	California
Gardena	California
Gilroy	California
Glendale	California
Glendora	California
Hanford	California
Hawthorne	California
Hayward	California
Hemet	California
Hesperia	California
Highland	California
Huntington Beach	California
Huntington Park	California
Indio	California
Inglewood	California
Irvine	California
Jurupa Valley	California
La Habra	California
La Mesa	California
La Mirada	California
La Puente	California
La Quinta	California
Laguna Niguel	California
Lake Elsinore	California
Lake Forest	California
Lakewood	California
Lancaster	California
Lincoln	California
Livermore	California
Lodi	California
Lompoc	California
Long Beach	California
Los Angeles	California
Lynwood	California
Madera	California
Manteca	California
Martinez	California
Menifee	California
Merced	California
Milpitas	California
Mission Viejo	California
Modesto	California
Monrovia	California
Montclair	California
Montebello	California
Monterey Park	California
Moreno Valley	California
Morgan Hill	California
Mountain View	California
Murrieta	California
Napa	California
National City	California
Newark	California
Newport Beach	California
Norwalk	California
Novato	California
Oakland	California
Oakley	California
Oceanside	California
Ontario	California
Orange	California
Oxnard	California
Pacifica	California
Palm Desert	California
Palm Springs	California
Palmdale	California
Palo Alto	California
Paramount	California
Pasadena	California
Perris	California
Petaluma	California
Pico Rivera	California
Pittsburg	California
Placentia	California
Pleasanton	California
Pomona	California
Porterville	California
Poway	California
Rancho Cordova	California
Rancho Cucamonga	California
Rancho Palos Verdes	California
Rancho Santa Margarita	California
Redding	California
Redlands	California
Redondo Beach	California
Redwood City	California
Rialto	California
Richmond	California
Riverside	California
Rocklin	California
Rohnert Park	California
Rosemead	California
Roseville	California
Sacramento	California
Salinas	California
San Bernardino	California
San Bruno	California
San Buenaventura (Ventura)	California
San Clemente	California
San Diego	California
San Francisco	California
San Gabriel	California
San Jacinto	California
San Jose	California
San Leandro	California
San Luis Obispo	California
San Marcos	California
San Mateo	California
San Rafael	California
San Ramon	California
Santa Ana	California
Santa Barbara	California
Santa Clara	California
Santa Clarita	California
Santa Cruz	California
Santa Maria	California
Santa Monica	California
Santa Rosa	California
Santee	California
Simi Valley	California
South Gate	California
South San Francisco	California
Stanton	California
Stockton	California
Sunnyvale	California
Temecula	California
Thousand Oaks	California
Torrance	California
Tracy	California
Tulare	California
Turlock	California
Tustin	California
Union City	California
Upland	California
Vacaville	California
Vallejo	California
Victorville	California
Visalia	California
Vista	California
Walnut Creek	California
Watsonville	California
West Covina	California
West Sacramento	California
Westminster	California
Whittier	California
Woodland	California
Yorba Linda	California
Yuba City	California
Yucaipa	California
Arvada	Colorado
Aurora	Colorado
Boulder	Colorado
Broomfield	Colorado
Castle Rock	Colorado
Centennial	Colorado
Colorado Springs	Colorado
Commerce City	Colorado
Denver	Colorado
Fort Collins	Colorado
Grand Junction	Colorado
Greeley	Colorado
Lakewood	Colorado
Littleton	Colorado
Longmont	Colorado
Loveland	Colorado
Northglenn	Colorado
Parker	Colorado
Pueblo	Colorado
Thornton	Colorado
Westminster	Colorado
Bridgeport	Connecticut
Bristol	Connecticut
Danbury	Connecticut
Hartford	Connecticut
Meriden	Connecticut
Middletown	Connecticut
Milford	Connecticut
New Britain	Connecticut
New Haven	Connecticut
Norwalk	Connecticut
Norwich	Connecticut
Shelton	Connecticut
Stamford	Connecticut
Waterbury	Connecticut
West Haven	Connecticut
Dover	Delaware
Wilmington	Delaware
Washington	District of Columbia
Altamonte Springs	Florida
Apopka	Florida
Aventura	Florida
Boca Raton	Florida
Bonita Springs	Florida
Boynton Beach	Florida
Bradenton	Florida
Cape Coral	Florida
Clearwater	Florida
Coconut Creek	Florida
Coral Gables	Florida
Coral Springs	Florida
Cutler Bay	Florida
Davie	Florida
Daytona Beach	Florida
Deerfield Beach	Florida
Delray Beach	Florida
Deltona	Florida
Doral	Florida
Fort Lauderdale	Florida
Fort Myers	Florida
Fort Pierce	Florida
Gainesville	Florida
Greenacres	Florida
Hallandale Beach	Florida
Hialeah	Florida
Hollywood	Florida
Homestead	Florida
Jacksonville	Florida
Jupiter	Florida
Kissimmee	Florida
Lakeland	Florida
Largo	Florida
Lauderhill	Florida
Margate	Florida
Melbourne	Florida
Miami	Florida
Miami Beach	Florida
Miami Gardens	Florida
Miramar	Florida
North Lauderdale	Florida
North Miami	Florida
North Miami Beach	Florida
North Port	Florida
Oakland Park	Florida
Ocala	Florida
Ocoee	Florida
Orlando	Florida
Ormond Beach	Florida
Palm Bay	Florida
Palm Beach Gardens	Florida
Palm Coast	Florida
Panama City	Florida
Pembroke Pines	Florida
Pensacola	Florida
Pinellas Park	Florida
Plantation	Florida
Pompano Beach	Florida
Port Orange	Florida
Port St. Lucie	Florida
Sanford	Florida
Sarasota	Florida
St. Cloud	Florida
St. Petersburg	Florida
Sunrise	Florida
Tallahassee	Florida
Tamarac	Florida
Tampa	Florida
Titusville	Florida
Wellington	Florida
West Palm Beach	Florida
Weston	Florida
Winter Garden	Florida
Albany	Georgia
Alpharetta	Georgia
Athens-Clarke County	Georgia
Atlanta	Georgia
Augusta-Richmond County	Georgia
Brookhaven	Georgia
Columbus	Georgia
Dunwoody	Georgia
Johns Creek	Georgia
Macon	Georgia
Marietta	Georgia
Peachtree Corners	Georgia
Roswell	Georgia
Sandy Springs	Georgia
Savannah	Georgia
Smyrna	Georgia
Valdosta	Georgia
Warner Robins	Georgia
Honolulu	Hawaii
Boise City	Idaho
Caldwell	Idaho
Coeur d'Alene	Idaho
Idaho Falls	Idaho
Meridian	Idaho
Nampa	Idaho
Pocatello	Idaho
Twin Falls	Idaho
Addison	Illinois
Arlington Heights	Illinois
Aurora	Illinois
Bartlett	Illinois
Belleville	Illinois
Berwyn	Illinois
Bloomington	Illinois
Bolingbrook	Illinois
Buffalo Grove	Illinois
Calumet City	Illinois
Carol Stream	Illinois
Carpentersville	Illinois
Champaign	Illinois
Chicago	Illinois
Cicero	Illinois
Crystal Lake	Illinois
Decatur	Illinois
DeKalb	Illinois
Des Plaines	Illinois
Downers Grove	Illinois
Elgin	Illinois
Elmhurst	Illinois
Evanston	Illinois
Glenview	Illinois
Hanover Park	Illinois
Hoffman Estates	Illinois
Joliet	Illinois
Lombard	Illinois
Moline	Illinois
Mount Prospect	Illinois
Naperville	Illinois
Normal	Illinois
Oak Lawn	Illinois
Oak Park	Illinois
Orland Park	Illinois
Palatine	Illinois
Park Ridge	Illinois
Peoria	Illinois
Plainfield	Illinois
Quincy	Illinois
Rock Island	Illinois
Rockford	Illinois
Romeoville	Illinois
Schaumburg	Illinois
Skokie	Illinois
Springfield	Illinois
Streamwood	Illinois
Tinley Park	Illinois
Urbana	Illinois
Waukegan	Illinois
Wheaton	Illinois
Wheeling	Illinois
Anderson	Indiana
Bloomington	Indiana
Carmel	Indiana
Columbus	Indiana
Elkhart	Indiana
Evansville	Indiana
Fishers	Indiana
Fort Wayne	Indiana
Gary	Indiana
Greenwood	Indiana
Hammond	Indiana
Indianapolis	Indiana
Jeffersonville	Indiana
Kokomo	Indiana
Lafayette	Indiana
Lawrence	Indiana
Mishawaka	Indiana
Muncie	Indiana
Noblesville	Indiana
South Bend	Indiana
Terre Haute	Indiana
Ames	Iowa
Ankeny	Iowa
Cedar Falls	Iowa
Cedar Rapids	Iowa
Council Bluffs	Iowa
Davenport	Iowa
Des Moines	Iowa
Dubuque	Iowa
Iowa City	Iowa
Sioux City	Iowa
Urbandale	Iowa
Waterloo	Iowa
West Des Moines	Iowa
Hutchinson	Kansas
Kansas City	Kansas
Lawrence	Kansas
Lenexa	Kansas
Manhattan	Kansas
Olathe	Kansas
Overland Park	Kansas
Salina	Kansas
Shawnee	Kansas
Topeka	Kansas
Wichita	Kansas
Bowling Green	Kentucky
Covington	Kentucky
Lexington-Fayette	Kentucky
Louisville	Kentucky
Owensboro	Kentucky
Alexandria	Louisiana
Baton Rouge	Louisiana
Bossier City	Louisiana
Kenner	Louisiana
Lafayette	Louisiana
Lake Charles	Louisiana
Monroe	Louisiana
New Orleans	Louisiana
Shreveport	Louisiana
Portland	Maine
Annapolis	Maryland
Baltimore	Maryland
Bowie	Maryland
Frederick	Maryland
Gaithersburg	Maryland
Hagerstown	Maryland
Rockville	Maryland
Attleboro	Massachusetts
Barnstable Town	Massachusetts
Beverly	Massachusetts
Boston	Massachusetts
Brockton	Massachusetts
Cambridge	Massachusetts
Chelsea	Massachusetts
Chicopee	Massachusetts
Everett	Massachusetts
Fall River	Massachusetts
Fitchburg	Massachusetts
Haverhill	Massachusetts
Holyoke	Massachusetts
Lawrence	Massachusetts
Leominster	Massachusetts
Lowell	Massachusetts
Lynn	Massachusetts
Malden	Massachusetts
Marlborough	Massachusetts
Medford	Massachusetts
Methuen	Massachusetts
New Bedford	Massachusetts
Newton	Massachusetts
Peabody	Massachusetts
Pittsfield	Massachusetts
Quincy	Massachusetts
Revere	Massachusetts
Salem	Massachusetts
Somerville	Massachusetts
Springfield	Massachusetts
Taunton	Massachusetts
Waltham	Massachusetts
Westfield	Massachusetts
Weymouth Town	Massachusetts
Woburn	Massachusetts
Worcester	Massachusetts
Ann Arbor	Michigan
Battle Creek	Michigan
Dearborn	Michigan
Dearborn Heights	Michigan
Detroit	Michigan
East Lansing	Michigan
Farmington Hills	Michigan
Flint	Michigan
Grand Rapids	Michigan
Kalamazoo	Michigan
Kentwood	Michigan
Lansing	Michigan
Lincoln Park	Michigan
Livonia	Michigan
Midland	Michigan
Muskegon	Michigan
Novi	Michigan
Pontiac	Michigan
Portage	Michigan
Rochester Hills	Michigan
Roseville	Michigan
Royal Oak	Michigan
Saginaw	Michigan
Southfield	Michigan
St. Clair Shores	Michigan
Sterling Heights	Michigan
Taylor	Michigan
Troy	Michigan
Warren	Michigan
Westland	Michigan
Wyoming	Michigan
Apple Valley	Minnesota
Blaine	Minnesota
Bloomington	Minnesota
Brooklyn Park	Minnesota
Burnsville	Minnesota
Coon Rapids	Minnesota
Duluth	Minnesota
Eagan	Minnesota
Eden Prairie	Minnesota
Edina	Minnesota
Lakeville	Minnesota
Mankato	Minnesota
Maple Grove	Minnesota
Maplewood	Minnesota
Minneapolis	Minnesota
Minnetonka	Minnesota
Moorhead	Minnesota
Plymouth	Minnesota
Rochester	Minnesota
Shakopee	Minnesota
St. Cloud	Minnesota
St. Louis Park	Minnesota
St. Paul	Minnesota
Woodbury	Minnesota
Biloxi	Mississippi
Gulfport	Mississippi
Hattiesburg	Mississippi
Jackson	Mississippi
Meridian	Mississippi
Southaven	Mississippi
Blue Springs	Missouri
Cape Girardeau	Missouri
Chesterfield	Missouri
Columbia	Missouri
Florissant	Missouri
Independence	Missouri
Jefferson City	Missouri
Joplin	Missouri
Kansas City	Missouri
Lee's Summit	Missouri
O'Fallon	Missouri
Springfield	Missouri
St. Charles	Missouri
St. Joseph	Missouri
St. Louis	Missouri
St. Peters	Missouri
Billings	Montana
Bozeman	Montana
Great Falls	Montana
Missoula	Montana
Bellevue	Nebraska
Grand Island	Nebraska
Lincoln	Nebraska
Omaha	Nebraska
Carson City	Nevada
Henderson	Nevada
Las Vegas	Nevada
North Las Vegas	Nevada
Reno	Nevada
Sparks	Nevada
Concord	New Hampshire
Manchester	New Hampshire
Nashua	New Hampshire
Atlantic City	New Jersey
Bayonne	New Jersey
Camden	New Jersey
Clifton	New Jersey
East Orange	New Jersey
Elizabeth	New Jersey
Hackensack	New Jersey
Hoboken	New Jersey
Jersey City	New Jersey
Kearny	New Jersey
Linden	New Jersey
New Brunswick	New Jersey
Newark	New Jersey
Passaic	New Jersey
Paterson	New Jersey
Perth Amboy	New Jersey
Plainfield	New Jersey
Sayreville	New Jersey
Trenton	New Jersey
Union City	New Jersey
Vineland	New Jersey
West New York	New Jersey
Albuquerque	New Mexico
Clovis	New Mexico
Farmington	New Mexico
Las Cruces	New Mexico
Rio Rancho	New Mexico
Roswell	New Mexico
Santa Fe	New Mexico
Albany	New York
Binghamton	New York
Buffalo	New York
Freeport	New York
Hempstead	New York
Mount Vernon	New York
New Rochelle	New York
New York	New York
Niagara Falls	New York
Rochester	New York
Schenectady	New York
Syracuse	New York
Troy	New York
Utica	New York
Valley Stream	New York
White Plains	New York
Yonkers	New York
Apex	North Carolina
Asheville	North Carolina
Burlington	North Carolina
Cary	North Carolina
Chapel Hill	North Carolina
Charlotte	North Carolina
Concord	North Carolina
Durham	North Carolina
Fayetteville	North Carolina
Gastonia	North Carolina
Greensboro	North Carolina
Greenville	North Carolina
Hickory	North Carolina
High Point	North Carolina
Huntersville	North Carolina
Jacksonville	North Carolina
Kannapolis	North Carolina
Raleigh	North Carolina
Rocky Mount	North Carolina
Wilmington	North Carolina
Wilson	North Carolina
Winston-Salem	North Carolina
Bismarck	North Dakota
Fargo	North Dakota
Grand Forks	North Dakota
Minot	North Dakota
Akron	Ohio
Beavercreek	Ohio
Canton	Ohio
Cincinnati	Ohio
Cleveland	Ohio
Cleveland Heights	Ohio
Columbus	Ohio
Cuyahoga Falls	Ohio
Dayton	Ohio
Dublin	Ohio
Elyria	Ohio
Euclid	Ohio
Fairfield	Ohio
Findlay	Ohio
Grove City	Ohio
Hamilton	Ohio
Huber Heights	Ohio
Kettering	Ohio
Lakewood	Ohio
Lancaster	Ohio
Lima	Ohio
Lorain	Ohio
Mansfield	Ohio
Mentor	Ohio
Middletown	Ohio
Newark	Ohio
Parma	Ohio
Springfield	Ohio
Strongsville	Ohio
Toledo	Ohio
Warren	Ohio
Westerville	Ohio
Youngstown	Ohio
Broken Arrow	Oklahoma
Edmond	Oklahoma
Enid	Oklahoma
Lawton	Oklahoma
Midwest City	Oklahoma
Moore	Oklahoma
Muskogee	Oklahoma
Norman	Oklahoma
Oklahoma City	Oklahoma
Stillwater	Oklahoma
Tulsa	Oklahoma
Albany	Oregon
Beaverton	Oregon
Bend	Oregon
Corvallis	Oregon
Eugene	Oregon
Gresham	Oregon
Hillsboro	Oregon
Keizer	Oregon
Lake Oswego	Oregon
Medford	Oregon
Portland	Oregon
Salem	Oregon
Springfield	Oregon
Tigard	Oregon
Allentown	Pennsylvania
Altoona	Pennsylvania
Bethlehem	Pennsylvania
Erie	Pennsylvania
Harrisburg	Pennsylvania
Lancaster	Pennsylvania
Philadelphia	Pennsylvania
Pittsburgh	Pennsylvania
Reading	Pennsylvania
Scranton	Pennsylvania
State College	Pennsylvania
Wilkes-Barre	Pennsylvania
York	Pennsylvania
Cranston	Rhode Island
East Providence	Rhode Island
Pawtucket	Rhode Island
Providence	Rhode Island
Warwick	Rhode Island
Woonsocket	Rhode Island
Charleston	South Carolina
Columbia	South Carolina
Florence	South Carolina
Goose Creek	South Carolina
Greenville	South Carolina
Hilton Head Island	South Carolina
Mount Pleasant	South Carolina
North Charleston	South Carolina
Rock Hill	South Carolina
Spartanburg	South Carolina
Summerville	South Carolina
Sumter	South Carolina
Rapid City	South Dakota
Sioux Falls	South Dakota
Bartlett	Tennessee
Brentwood	Tennessee
Chattanooga	Tennessee
Clarksville	Tennessee
Cleveland	Tennessee
Collierville	Tennessee
Franklin	Tennessee
Germantown	Tennessee
Hendersonville	Tennessee
Jackson	Tennessee
Johnson City	Tennessee
Kingsport	Tennessee
Knoxville	Tennessee
Memphis	Tennessee
Murfreesboro	Tennessee
Nashville	Tennessee
Smyrna	Tennessee
Abilene	Texas
Allen	Texas
Amarillo	Texas
Arlington	Texas
Austin	Texas
Baytown	Texas
Beaumont	Texas
Bedford	Texas
Brownsville	Texas
Bryan	Texas
Burleson	Texas
Carrollton	Texas
Cedar Hill	Texas
Cedar Park	Texas
College Station	Texas
Conroe	Texas
Coppell	Texas
Corpus Christi	Texas
Dallas	Texas
Denton	Texas
DeSoto	Texas
Duncanville	Texas
Edinburg	Texas
El Paso	Texas
Euless	Texas
Flower Mound	Texas
Fort Worth	Texas
Friendswood	Texas
Frisco	Texas
Galveston	Texas
Garland	Texas
Georgetown	Texas
Grand Prairie	Texas
Grapevine	Texas
Haltom City	Texas
Harlingen	Texas
Houston	Texas
Huntsville	Texas
Hurst	Texas
Irving	Texas
Keller	Texas
Killeen	Texas
Lancaster	Texas
Laredo	Texas
League City	Texas
Lewisville	Texas
Longview	Texas
Lubbock	Texas
Mansfield	Texas
McAllen	Texas
McKinney	Texas
Mesquite	Texas
Midland	Texas
Mission	Texas
Missouri City	Texas
New Braunfels	Texas
North Richland Hills	Texas
Odessa	Texas
Pasadena	Texas
Pearland	Texas
Pflugerville	Texas
Pharr	Texas
Plano	Texas
Port Arthur	Texas
Richardson	Texas
Rockwall	Texas
Round Rock	Texas
Rowlett	Texas
San Angelo	Texas
San Antonio	Texas
San Marcos	Texas
Sherman	Texas
Sugar Land	Texas
Temple	Texas
Texarkana	Texas
Texas City	Texas
The Colony	Texas
Tyler	Texas
Victoria	Texas
Waco	Texas
Weslaco	Texas
Wichita Falls	Texas
Wylie	Texas
Bountiful	Utah
Draper	Utah
Layton	Utah
Lehi	Utah
Logan	Utah
Murray	Utah
Ogden	Utah
Orem	Utah
Provo	Utah
Riverton	Utah
Roy	Utah
Salt Lake City	Utah
Sandy	Utah
South Jordan	Utah
Spanish Fork	Utah
St. George	Utah
Taylorsville	Utah
West Jordan	Utah
West Valley City	Utah
Burlington	Vermont
Alexandria	Virginia
Blacksburg	Virginia
Charlottesville	Virginia
Chesapeake	Virginia
Danville	Virginia
Hampton	Virginia
Harrisonburg	Virginia
Leesburg	Virginia
Lynchburg	Virginia
Manassas	Virginia
Newport News	Virginia
Norfolk	Virginia
Portsmouth	Virginia
Richmond	Virginia
Roanoke	Virginia
Suffolk	Virginia
Virginia Beach	Virginia
Auburn	Washington
Bellevue	Washington
Bellingham	Washington
Bremerton	Washington
Burien	Washington
Edmonds	Washington
Everett	Washington
Federal Way	Washington
Kennewick	Washington
Kent	Washington
Kirkland	Washington
Lacey	Washington
Lakewood	Washington
Marysville	Washington
Olympia	Washington
Pasco	Washington
Puyallup	Washington
Redmond	Washington
Renton	Washington
Richland	Washington
Sammamish	Washington
Seattle	Washington
Shoreline	Washington
Spokane	Washington
Spokane Valley	Washington
Tacoma	Washington
Vancouver	Washington
Yakima	Washington
Charleston	West Virginia
Huntington	West Virginia
Appleton	Wisconsin
Beloit	Wisconsin
Brookfield	Wisconsin
Eau Claire	Wisconsin
Fond du Lac	Wisconsin
Green Bay	Wisconsin
Greenfield	Wisconsin
Janesville	Wisconsin
Kenosha	Wisconsin
La Crosse	Wisconsin
Madison	Wisconsin
Milwaukee	Wisconsin
New Berlin	Wisconsin
Oshkosh	Wisconsin
Racine	Wisconsin
Sheboygan	Wisconsin
Waukesha	Wisconsin
Wausau	Wisconsin
Wauwatosa	Wisconsin
West Allis	Wisconsin
Casper	Wyoming
Cheyenne	Wyoming